+--+--+--+  +--+--+--+  +--+--+--+  +--+--+--+  +--+--+--+  +--+--+--+  +--+--+--+
|        |  |        |  |        |  |        |  |        |  |        |  |        |
+  +--+--+  +  +--+--+  +  +--+--+  +--+  +--+  +  +--+--+  +  +--+--+  +--+  +--+
|        |  |        |  |        |  |        |  |        |  |        |  |        |
+  +--+--+  +--+  +--+  +--+--+  +  +--+  +--+  +  +--+  +  +--+  +  +  +  +--+  +
|        |  |        |  |        |  |        |  |     |  |  |     |  |  |     |  |
+--+--+--+  +--+--+--+  +--+--+--+  +--+--+--+  +--+--+--+  +--+--+--+  +--+--+--+

+--+--+--+  +--+--+--+  +--+--+--+  +--+--+--+  +--+--+--+  +--+--+--+  +--+--+--+
|        |  |        |  |        |  |        |  |        |  |        |  |        |
+--+  +--+  +--+--+  +  +--+--+  +  +  +--+--+  +--+  +--+  +  +--+  +  +  +--+  +
|        |  |        |  |        |  |        |  |        |  |     |  |  |     |  |
+--+  +  +  +  +--+  +  +--+  +  +  +  +  +  +  +  +  +  +  +  +--+--+  +--+  +--+
|     |  |  |     |  |  |     |  |  |  |  |  |  |  |  |  |  |        |  |        |
+--+--+--+  +--+--+--+  +--+--+--+  +--+--+--+  +--+--+--+  +--+--+--+  +--+--+--+

+--+--+--+  +--+--+--+  +--+--+--+  +--+--+--+  +--+--+--+  +--+--+--+  +--+--+--+
|        |  |        |  |        |  |        |  |        |  |        |  |        |
+  +--+  +  +  +--+--+  +--+  +  +  +--+  +  +  +  +--+  +  +  +--+  +  +--+  +  +
|     |  |  |     |  |  |     |  |  |     |  |  |     |  |  |     |  |  |     |  |
+--+--+  +  +--+  +  +  +--+  +--+  +--+--+  +  +  +--+  +  +--+  +  +  +  +--+  +
|        |  |        |  |        |  |        |  |     |  |  |     |  |  |     |  |
+--+--+--+  +--+--+--+  +--+--+--+  +--+--+--+  +--+--+--+  +--+--+--+  +--+--+--+

+--+--+--+  +--+--+--+  +--+--+--+  +--+--+--+  +--+--+--+  +--+--+--+  +--+--+--+
|        |  |        |  |        |  |        |  |        |  |        |  |     |  |
+  +--+  +  +  +--+  +  +--+  +  +  +--+  +--+  +  +  +  +  +  +  +--+  +--+  +  +
|     |  |  |     |  |  |     |  |  |     |  |  |  |  |  |  |  |  |  |  |        |
+  +  +--+  +  +--+  +  +  +  +--+  +  +  +  +  +--+  +--+  +--+  +  +  +  +  +--+
|  |     |  |  |     |  |  |     |  |  |     |  |        |  |        |  |  |     |
+--+--+--+  +--+--+--+  +--+--+--+  +--+--+--+  +--+--+--+  +--+--+--+  +--+--+--+

