+--+--+--+--+  +--+--+--+--+  +--+--+--+--+  +--+--+--+--+
|           |  |           |  |        |  |  |           |
+--+--+--+  +  +  +--+  +  +  +  +--+  +  +  +  +--+  +  +
|        |  |  |     |  |  |  |     |     |  |     |  |  |
+--+--+  +  +  +--+  +  +--+  +--+--+  +--+  +  +--+--+--+
|     |     |  |     |     |  |        |  |  |           |
+--+  +  +--+  +  +  +  +--+  +  +--+  +  +  +--+  +  +--+
|           |  |  |  |     |  |  |        |  |     |     |
+--+--+--+--+  +--+--+--+--+  +--+--+--+--+  +--+--+--+--+
